1112132111330313123111212
1230302312032122110303030
3011022221203101122310232
1233301030121032302231222
3222031111223222223023022
2021103110102101022221102
2303111231303231222303230
2210323012110302222210212
2232223111232110230111232
2102220312021123031121020
3121012221223222303211212
3222322212222210230121122
2210210122102303021211222
2112123221230231012232222
0321210212302103111021022
3012312230211230112301222
2321030221113011122112112
3021123031120323111230322
1211202111011010312211020
3030110311112311030311212
1212323111121013221032102
2230222321221130023101112
3023022223011231221111120
2111011010311022212311212
1111111111111111111011110