3311323312
1233300322
3022313100
1102123312
3110302222
2332132322
2221223112
3323212312
1230302230
1011111110